NO ./textures/wall_1.xpm
WE ./textures/wall_2.xpm
EA ./textures/wall_3.xpm
SO ./textures/wall_4.xpm
S ./textures/sprite_3.xpm
F 200, 50, 10
C 10, 10, 10
R 300 300

11111
1 E 21
1   1
1 2 1
11111
